1111111111111111111
1P000000000000000C1
1010101110101010X01
1000C00000C00000C01
1010101110101010X01
1000000C00000C00C01
1010101110101010X01
1000000000000000C01
1000C00000C00000001
1010101110101010X01
100000000000000E001
1111111111111111111
