111111111111111111
1P0000000C00000C11
100011X010X1110011
1010X010000C000X01
101111011101X11101
1C00000000000000E1
111111111111111111
