11111111111111111111
1P0C00CX00000C00XC11
101010101X1101010101
1C00XC0000000C00XC11
10111X010X101X101011
1C0000C000X0C0000E11
11111111111111111111
