1111111111111111111
1P000000000000C0001
1000000000000000001
1000C00000C00000001
1000000000000000001
1000000000000000001
10000000000000X0001
1000000000000000001
1000C00000C00000001
1000000000000000001
100000000000000E001
1111111111111111111
