11111111111111111111111111111
1P000000000C00000000000000011
10111111111111111000000000011
1010000C000000001000000000011
10100000000000001000000000011
10100000000000001111111110011
10111111111110000000000010011
10000000000010000000000010011
1000000000001000000X000C10011
1000000C000011111111111110011
10000000000000000000000000011
100000000000000000X0000000011
10000111111111111111111000011
1000010000C000000000001000011
10000100000000000000001000011
100001000000000X0000001000011
1000010000000000000C001000011
10000111111111111111111000011
10000000000000000000000000011
100000000000C0000000000E00011
11111111111111111111111111111
