1111111111111111111111111
1P00000000000C00000000001
1000011111000000111000001
1000100001000000001000001
1000100C01000C00001000001
1000111111000000111000001
1000000000000000000000001
1000000000000000000000001
100000000000X000000000001
1000111111000000111000001
1000100001000C00001000001
1000100C01000000001000001
1000011111000000111000001
100000000000X000000000001
1000000000000000000000E01
1111111111111111111111111
