1111111111111111111111111111111111111111
1E00000000000000000C00000000000000000001
1000000000000000000000000000000000000001
1000P00000000000000000000000000000000001
1000000000000000000000000000000000000001
1000000000000000000X00000000000000000001
1000000000000000000000000000000000000001
1000000000000C00000000000000000C00000001
1000000000000000000000000000000000000001
1000000000000000000X00000000000000000001
1000000000000000000000000000000000000001
1000000000000C00000000000000000000000001
1000000000000000000000000000000000000001
1000000000000000000000000000000000000001
1111111111111111111111111111111111111111
